######################################
#***********************************<#
#*####################################
#*#********************##************#
#*#######*########*###*##*############
#******************##*###*******####*#
#*#####*#######*#####*#########*##***#
#***********************#*******####*#
######*#######*######*###*######*****#
#*****************#######********###*#
##*####*#####*####********######*****#
#**####*#*****####*#*#######****####*#
#####*****########*#***#####*##******#
#*****###**********###****##*#**######
#*#**#*###*###*###*########*#**#######
#***##*##**###*###*########*********##
#*##***##***##**##**********#######*##
#****###**#*******#*#*#########******#
####################################*#